11111111111111111111
10000000000000000001
10101010001010101001
10000000000000000001
10101010101010101001
10000000000000000001
10000000000000000000
