WE maps/north.xpm
EA maps/north.xpm
NO maps/east.xpm
SO maps/east.xpm

C 10,25,25
F 0,0,0

111111111111111111111111111111111
111000000000000000000000001111111
100000000000111101001010100001111
111000000000000000000001100000001
111111111111100000000000000000111
111100000000000111111110000100001
111100000000000000000011111111011
111000000111110000000101010101011
111111110000000000000000000000001
111111111000000000000000000000101
111111111011000001110000000000001
100000000011000001110111111111111
11110111111111011100000010001
11110111111111011101010010001
11000000110101011100000010001
10000000000000001100000010001
1000N000000000001101010010001
110000011101010111110111100011111
11110111 1110101 101111010001
11111111 1111111 111111111111
