WE maps/north.xpm
EA maps/north.xpm
NO maps/east.xpm
SO maps/east.xpm

C 10,25,25
F 0,0,0

111111111111111111
100000011000000001
111100000011001111
100100010000100001
100000000000010001
111N00000100000001
110000000000001111
111100010000000101
111111111111111111
