WE maps/west.xpm
EA maps/east.xpm
NO maps/north.xpm
SO maps/south.xpm

C 10,25,25
F 0,0,0

        1111111111111111111111111
        1000000000110000000000001
        1011000001110000000000001
        1001000000000000000000001
111111111011000001110000000000001
100000000011000001110111111111111
11110111111111011100000010001
11110111111111011101010010001
11000000110101011100000010011
10000000000000001100000010001
10000001110000001101010010001
100000011101010111110111100011111
11110111 1110101 101111010111
1111111 1111111 1111111111111
