WE maps/north.xpm
EA maps/north.xpm
NO maps/east.xpm
SO maps/east.xpm

C 10,25,25
F 0,0,0

        111111111111111111111111
        10000S0000110000000000001
        1011000001110000010000001
        1001000000000000001000001
 11111111011000000000000000001
100000000011000000000000000000111111111111
11101111111110000010000000000000001
111101111111100010010000000000000001
111111000000000000000000001111111111111111
110000011100011100000010000000000000001
10000000000000001100000010001
1000000000000000111010010001  1
110000011101010111110111100111
11110111 1110101 101111010001         1
1 111111 1111111 11111111111
